assign map0 = {
    40'b1110111110001111111111111111111111111111,
    40'b1100011101111111111111111111111111111111,
    40'b1000001101111010011110000111110000000011,
    40'b1101011101111001101101111011101111111011,
    40'b1111111100011011101101111011011111111011,
    40'b1111011101101011101101111010111111111011,
    40'b1111011101101001101101110010111111111011,
    40'b1111101101101010011100001110111111111011,
    40'b1111101111111111111101111111000011001011,
    40'b1111110111111111111101111111111010101011,
    40'b1111111001111111111101111111110111111011,
    40'b1111111110111111111101111111101110101011,
    40'b1111111110111111111101111111101110101011,
    40'b1111111110111111111111111111101111111011,
    40'b1111111101111111110111101110110000000011,
    40'b1111111100111111101111101110111111111111,
    40'b1111111001111111100111001100100011011011,
    40'b1111111100111111101010101010110101011011,
    40'b1111111011011111101011001100111011011011,
    40'b1111110111101111111111111111111111000011,
    40'b1111110111101111111111111111111111011011,
    40'b1111110111101111111111111111111111011011,
    40'b1111110111101111111111111111111111011011,
    40'b1111111011011111111111111111111111111111,
    40'b1111111100111111111111111111111111111111
};
